111111111111111111111
1000000000000000P0001
100000000000000000001
1000C0000000000000C01
111111111111111111111
10000E000000000000001
111111111111111111111