11111111111
1000E0C0001
1000P00C001
10011111001
100C0000011
1000C000001
10011111001
100C0000001
1000C0Z0001
11111111111