111111111111111111111
100000000000000000001
100000000000000000001
1000C0000000000000001
10000000C000000000001
10000E0000000000000E1
111111111111111111111