111111111111111101111
1E00000000000000P0001
100000000000000000001
1000C0000000000000001
10000000C000000000001
10000E000000000000001
111111111111111111111