1111111111111111111111111111111111111111111111111111111111
1E00000000000000C000000000000000000000000000000000000P0001
1000000000000000000000000000000000000000000000000000000001
1000C00000000000000000000000000000000000000000000000000001
10000000C00000000000000C0000000000000000000000000000000001
1000000000000000000000000000C00000000000000000000000000001
1111111111111111111111111111111111111111111111111111111111