111111111111111111111111111111
1E0000000000000C1111111C111111
10011111111111000000000C0000C1
1000000C0000000011111111111011
1101111111111100000000000000C1
1000000C00000C0011111111011111
100111111111110000000000000001
1C000000000000P000000000C00001
111111111111111111111111111111
