11111111111111
1E000111110001
10101000001001
101010C1100101
1010101C010101
10101001010101
10101000010101
10100111100101
100100000C1001
10001111110C01
100000000000P1
11111111111111