1111111111111111
1EC1100000011C01
1001100000011001
1000000000000001
1000C0000000C001
100110000C011001
100C111111110001
10000000000000P1
1111111111111111